111111111111111
1C00020000000C1
1000001C1000001
1P00001110000C1
1000001E1000001
100C0000000C001
111111111111111